NO ./path_to_the_north_texture
SO ./path_to_the_south_texture
WE ./path_to_the_west_texture
EA ./path_to_the_east_texture

F 220,100,0
C 225,30,0

 1111111        111111111
110000011      10000000001
100000001     1000000000001
 1000001     100000000000001
  11011      1000000000000001
   101        1000000100000001
   101         100001 100000001
   101111111111100000100000001
   10000000000000000000000001
   1011111111111000000000001
   101         100000000001
   101        10000E000001
  11011      100000000001
 1000001     100000000001
100000001     10000000001111111
110000011      1000000000000001
 1111111        111111111111111