NO texture/wood.xpm
SO texture/blue_stone.xpm
EA texture/color_stone.xpm
WE texture/mossy.xpm
DO texture/eagle.xpm

F 102,104,0
C 0,128,255

 1111111        111111111
110000011      10000000001
100000001     1000000000001
 1000001     100000000000001
  11011      1000000000000001
   101        1000000100000001
   101         100001 100000001
   101111111111100000100000001
   100000000000W0000000000001
   1011111111111000000000001
   101         100000000001
   101        100000000001
  11011      100000000001
 1000001     100000000001
100000001     10000000001111111
110000011      1000000000000001
 1111111        111111111111111